"0xca19cc","Type?","##UNKNOWN##","UNKNOWN","##UNKNOWN##","Chest/???","##UNKNOWN##","X Coordinate","Y Coordinate","Type","##UNKNOWN##"
"0x0","0x7","0x0","0x8","0x0","0x75","0x0","0xb","0x5","0x12","0x0"
"0x1","0x8","0x0","0x0","0x0","0x1","0x0","0xb","0x3","0x10","0x0"
"0x2","0x8","0x0","0x0","0x0","0x1","0x0","0x1","0x3","0x10","0x0"
"0x3","0x8","0x0","0x0","0x0","0x1","0x0","0xb","0x7","0x10","0x0"
"0x4","0x8","0x0","0x0","0x0","0x1","0x0","0x6","0x3","0x10","0x0"
"0x5","0x8","0x0","0x0","0x0","0x1","0x0","0xf","0x3","0x10","0x0"
